  _      ________      ________ _        ___  
 | |    |  ____\ \    / /  ____| |      |__ \ 
 | |    | |__   \ \  / /| |__  | |         ) |
 | |    |  __|   \ \/ / |  __| | |        / / 
 | |____| |____   \  /  | |____| |____   / /_ 
 |______|______|   \/   |______|______| |____|