  _      ________      ________ _        ____  
 | |    |  ____\ \    / /  ____| |      |___ \ 
 | |    | |__   \ \  / /| |__  | |        __) |
 | |    |  __|   \ \/ / |  __| | |       |__ < 
 | |____| |____   \  /  | |____| |____   ___) |
 |______|______|   \/   |______|______| |____/