11111111111111111111111111111111111111111111111111
1             12                                 1
1        1    111111111117                    1  1
1    N   1              11111111111           1  1
1 N  11551       1      1         11  7      11  1
1 Aa1111111111111111    1    1    1111111111111  1
1 11               1         1                   1
1                  1         151511111111111111  1
1                  111155511111111            1  1
1                     11111                   1  1
1                                      111    1  1
1                                      111    1  1
1                                      111    1  1
1                                      111    1  1
1                                      111    1  1
1                                      111    1  1
1                                      111    1  1
1                                     11115   1  1
1                                    1111115     1
1                           1111111111111111111111
1                                                1
1                                                1
1                                                1
1                                                1
1                                                1
1                                                1
1                                                1
1                                                1
11111111111111111111111111111111111111111111111111

