11111111111111111111111111111111111111111111111111
1         aa            AA4        Oba           1
1         11    11111111111   111111111          1
1         11            11    155555511    11    1
1         11            11           11    11    1
1N        BB    1111    11      1    11555511    1
11111111AA1111111111    11      1    11111111    1
1               1111    11   5  1  5       N     1
1               1111    11   1     1 BBaaaa1a    1
1           11  1111    11   1     1          1  1
1           11  1111    11   1     1          1  1
1        11111          11                    1  1
1   11   11111   11     11555555555555555555551  1
1   1155511111        1111111111111111111111111  1
14NO1111111111555555551111111111111111111111111991
11111111111111111111111111111111111111111111111111








