11111111111111111111111111111111111111111111111111
1             12                                 1
1        1    111111111117    6               1  1
1        1              11111111111           1  1
1    11551       1      1         11  7      11  1
11111111111111111111    1    1    1111111111111  1
1                  1         1   6         2     1
1                  1         151511111111111111881
1                  111155511111111            1  1
1                     11111                   1  1
1                                      111    1  1
1                                      111    1  1
1                                      111    1  1
1               6                      111    1  1
1                                      111    1  1
1                                      111    1  1
1                                      111    1  1
1                                     11115   1  1
1                                6   1111115     1
1                           1111111111111111111111
1                                                1
1                                                1
1                                                1
1                                                1
1                                                1
1                                                1
1                                                1
1                                                1
11111111111111111111111111111111111111111111111111

