1111111111111111111111111111111111111111111111111111111111111111111111111111111111111111111111111111
1         aa            AA4        Oba           1            a51                                  1
1         11    11111111111   11111111>          1AAAAAAAA1   a51                                  1
1        <11            11    1      <1    11    1N15555551   a51                                  1
1>        11            11           11    11    1a11111111   a51       11111111111111111111       1
1N    1   BB    <111    11      1    11555511    1            a51>                         1       1
11111111AA1111111111    11      1    11111111    1            a51       O                  1       1
1      a        1111    11   5  1  5       N     1            111BBBBBB aaaaaaaaaaaaaaaaaaa1       1
1               1111    11   1     1 BBaaaa1a    1 11aaaaaa11111155555B                    1  1    1
1           11  1111    11   1     1          1  1  1      111111BBBBBB                    1  1    1
1           11  1111    11   1     1          1  15 1        a O1                         <1  1    1
1   NO   11111         <11                    1  1  1      1111B1     NAAAAAAAAAAAAAAAAAAAA1  1    1
1   11   11111   11     11555555555555555555551  1  1          N1     1555555555555555555551  1    1
1   1155511111        1111111111111111111111111  1  1AAAAAA111111     1555555555555555555551  1    1
1 4 1111111111555555551111111111111111111111111  4  1           B     1555555555555555555551  1    1
11111111111111111111111111111111111111111111111111111111111111111111111111111111111111111111  111111 
1                                  B             1                  1   1         111111   A  A    1
1                                  B            N1>       1>        1   1    <a            A  A    1
1                                  1       1111111       <1         1   1     a   1  1 1   A  A    1
1                                  1            <1>       1>        1   1    <a   155551   A  A    1
1                                  1             1       <1         1   1     a   1    1   A  A    1
1aaa11111111111111111111111111111111            <1>       1>        1   1    <a            A  A    1
1>                                 1             11111   <1             1     a   1    1   A  A    1
1AAA111111111111111111111 11111   <1            <1>       1>        1        <a   155551   A  A    1
1                      1      1N   1             1  11111111111111111111111111111111111111aAN4Aa1111
1                      1      111111            <1>                                       111111   1
1         1  1         1           1             1                                                <1
1         1  1         155551      1            <1>                                                1
1         1N 11111111111111111111 11             11111111111111111111111                          <1
1    1111111a1         1>          1            <1>                    1N                          1
1                      1>          1             11111111   111111     11                         <1
1                1111111           1            <1>              1     111111111111111111111111    1
1                1O    b      155551             1               1                                <1
1                1111111  11111111111111111111   1>              1111111111111111111111            1
1                155551>  A                      1111111111111                        1           <1
1                1>       A                      1>                                   11111111111111
1                155551>  A                  1  O4       1                                        <1
1                11111111111111111111111111111111111111111111111111111111111111111111111111111111111
1                                                1                                                 1
1                                                1                                                 1
1                                                1                                                 1
1                                                1                                                 1
1                                                1                                                 1
1                                                1                                                 1
1                                                1                                                 1
1                                                1                                                 1
1                                                1                                                 1
1                                                1                                                 1
1111111111111111111111111111111111111111111111111111111111111111111111111111111111111111111111111111










