11111111111111111111111111111111111111111111
1                                          1
1                                          1
1                                          1
1                                          <
1111111111111111111111111111111111111111  11
1                                          1
1    >                                     1
>                                          1
1    >                                     1
111  111111111111111111111111111111111111111
>                                        9 1
>                                          1
>                                          <
>                                          <
11111111111111111111111111111111111111111111


