11111111111111111111111111111111111111111111111111
1         aa            AA4                      1
1         11    11111111111   11111              1
1         11            11    15551              1
1         11            11                       1
1N  4     11    1111    11      1                1
11111111AA1111111111    11      1    11111111    1
1               1111    11   5  1  5             1
1               1111    11   1     1             1
1           11  1111    11   1     1          1  1
1           11  1111    11   1     1          1  1
1        11111          11                    1  1
1   11   11111   11     11555555555555555555551  1
1   1155511111        1111111111111111111111111  1
1P  1111111111555555551111111111111111111111111  1
11111111111111111111111111111111111111111111111111








